5
10
S---------
------D---
--J-------
----D-----
--D----D--

